XXXXXXSSSS
XXXXXSSSSS
XXXXXSSSSS
XXXXXXSSSS
XXXXXXSSSS
XXXXXXXSSS
XXXXXXXXSS
XXXXXXXSXX
XXXXXXXXXX
XXXXXXXXXX