OOOOOOOOOOOOOOO
OOOOOOOOOOOOOOO
OOOOOOOOOOOOOOO
OOOOOGGGGGOOOOO
OOOOGGGGGGGOOOO
OOOGGGGGGGGGOOO
OOOGGGGGGGGGOOO
OOOGGGGGGGGGOOO
OOOGGGGGGGGGOOO
OOOGGGGGGGGGOOO
OOOOGGGGGGGOOOO
OOOOOGGGGGOOOOO
OOOOOOOOOOOOOOO
OOOOOOOOOOOOOOO
OOOOOOOOOOOOOOO