XXXXXXXXXXXXXXX
XXSSGSSSSGXXGGG
SSXSSSSGGGSGGGG
SSSSSTGGGGGGGGG
TTTTTTGGGGGGGGG
TTTTTTTGGGGGGGG
TTTTTTTGGGGGGGG
TTTTTTTGGTGGGGG
TTTTGGGGGTTTTGG
TTTGGGGGGTTTTTT
TTTGGGGGGGGGGTT
TTTGGGGGGGGGGTT
TTTTGGGGGTTTTTT
TTTTTTGGTTTTTTT
TTTTTTGGTTTTTTT