XXXXXXSSSSSSSSS
XXXXXSSSSSSSSSS
XXXXXSSSSSSSSSS
XXXXXXSSSSSSSSS
XXXXXXSSSSSSSSS
XXXXXXXSSSSSSSS
XXXXXXXSSSSSSSS
XXXXXXXSSXSSSSS
XXXXSSSSSXXXXSS
XXXSSSSSSXXXXXX
XXXSSSSSSSSSSXX
XXXSSSSSSSSSSXX
XXXXSSSSSXXXXXX
XXXXXXSSXXXXXXX
XXXXXXSSXXXXXXX