TTTTTTGGTTTTTTT
TTTTGGGGGGGGTTT
TGGGGGGGGGGGGGT
GGGGGGGGGGGGGGG
GGGGGGGGGGGGGGG
GGGGGGGGGGGGGGG
GGGGGGGGGGGGGGG
GGGGGGGGGGGGGGG
GGGGGGGGGGGGGGG
GGGGGGGGGGGGGGG
GGGGGGGGGGGGGGG
GGGGGGGGGGGGGGG
GGGGGGGGGGGGGGG
GGGGGGGGGGGGGGG
GGGGGGGGGGGGGGG