OOOOOOOOOOOOOOO
OOOOOOOOOOOOOOO
OOOOOOOOOOOOOOO
OOOOOGGGGGGOOOO
OOOOGGGGGGGOOOO
OOOOGGGGGGOOOOO
OOOOGGGGOGGOOOO
OOOOGGGGGGGOOOO
OOOOGGOGGGGOOOO
OOOOGGGGGGGOOOO
OOOOGGGOGGGOOOO
OOOOGGGGGGOOOOO
OOOOOOOOOOOOOOO
OOOOOOOOOOOOOOO
OOOOOOOOOOOOOOO