OOOOOOOOOOOOOOO
OOOOOOOOOOOOOOO
OOOOOOOOOOOOOOO
OOOOOGGGGGGOOOO
OOOOGOOOGGGOOOO
OOOOGGOOGOOOOOO
OOOOGGGGGGGOOOO
OOOOGOGGGGGOOOO
OOOOGGOGGGGOOOO
OOOOOOGGOOOOOOO
OOOOGGGOGGGOOOO
OOOOOOGGGGOOOOO
OOOOOOOOOOOOOOO
OOOOOOOOOOOOOOO
OOOOOOOOOOOOOOO